10,10
1,1,1,1,1,1,1,1,1,1,
1,0,0,0,0,0,0,1,0,1,
1,0,0,0,0,3,3,0,0,1,
1,0,0,0,0,0,1,0,0,1,
1,5,0,3,0,0,0,0,0,1,
1,0,0,3,0,0,1,0,0,1,
1,0,0,0,0,0,1,0,0,1,
1,0,1,1,1,1,1,1,1,1,
1,0,0,0,0,0,0,0,0,1,
1,1,1,1,2,3,1,3,2,1,
